####################################################################################################
##..[]..[].[].[]##[][][][][]..[]....[][][]##[]....[]........[].[][][]..[][].........[][]........[]##
##....[][]##[][].....[]....[]...##..[].[][][][][].[]......##[][]....[]..[]##.........[][].[]####[]##
##......[]..##..[]............[][][][]...[]...##[]....[]............[]......[].............[].....##
##............................[][]##[]........[]##..##[]..##..[]...[][][]...[]....[]....##[]......##
##[]..[]........##............................[][]..[][]##..........[][][].[]...##......[][]......##
##..[]....................##..............[]...[]............[].......##..[].[]..[]....[].........##
##..[]##..............##................##.[]...[]..[]##................[]........................##
##....................[]...[][]..[]..........[].....##[]...[]..[]...............................####
##......[].......[].......[][]##..[]........[]..................[]##.........[]...............##[]##
##......[]##[]...[]......[].[]...[][].......[][]...[].............##......@..[]...............[][]##
##..[]..##..[][]##..........[]..[]..##.........[]......[].............[]...[]...##..........[][][]##
##....[][]..####[]..##......[][][][]..[]......##[]......##..##.........[][]...............##......##
##..[][][]##[][]......................##...[]....[].........##[]......[].[]...[]..####[]..........##
##....##[][][]............[]....[][]...[][][]...............[][]##..##....[][]....[][]##...[].....##
##.[][][]...........##..........[]......##..##................##[]......##..[]..........[]####....##
##[][][]...[].......[]..........##..##..##..[].......[][].....[]................[]....##[]........##
##...[]..[].....##......[].[].......[]...[].......##......[]##.[]...................##..[]...[]...##
##.......[]............[].[][]......[]....##..........[]..##.....[].....##..[]..##[][]..[]####....##
##[][]..........##.[].......[]......[][]................[]........[][]####[][]..[]..[]..........[]##
##[]##[]................##.[]......[]...##......................##[]..........##..[]##[]..[]......##
##[].[]..........[]...[]..[][]....[]..............##..##[]....[][]##..[]........[][]..[]..........##
##[].[]..................[].[][]............[][].......[][][][].[][][][][][]##........[]....[][][]##
##[]....................[][][]...........................[].........##......[]....[][]........[]..##
##..[]......##.........[][]...[]........##.........[].[][]..##[]..[]..##..[]..[]......##[]..[]######
##..##[][]...[].[]......##......[].................[].....##[]............[]......[]..[][]....[]..##
##..##.........................[]..[].......[][][]..[]....[]......[]..[]..............[][]....[]####
##..............................[]...[]...[]####[]..........[][]..[][]....##[]........##........[]##
##........[].......[]..........[][].[]..[][].[][]...........[]##....[]..[]..[]....[]....[][][][][]##
##....##.[][]...##[]##[]........[]##[]..##.[].##......####..............[][]..##..##....[]..[][]..##
##......[].[].[][]##......[].[]..[]..[][].[][][]..........##[]..[]....[][]....[]##..[]......[][][]##
##..[].......[].##[]..[].....[][].......[]##......##[]..[]....[]..##[]......[]..[]##....[][]##..[]##
##....[]......##.[].....##....[]....##..[]##....[]..[]..[]..........##..........[]##[]..[][]..##..##
##...........[].##[].[]........[].....................[]......[]......[]##..........[][]..[][]....##
##[][]....[][].[].[]##.....[]...................[]......[][]........[]......[]..........[][]......##
##........[].....[]..[]....[][].....##....[]..........[]....##[]..[][][]##........[]..[][][]....[]##
##..................##[][]##[][]....##......####[]....[][]####[]..[][]..[][]..[]....[]....[]....[]##
##.....[].............[][]....[]##........##....[]..[]..##[]......[][][]##[][]..[]..............[]##
##[]..................##..##..##..............[]..####........[]......[]..[][]..[]##..[]##........##
##.[][][]...............##....##..[][]......##[]..##....[]........................[]..[]##....##..##
##..##..[][]..............[]##....[]....[]..[]....[]....[]................##......[]..[]..[]..[][]##
####[].[][][][]...........[]....[][]..[][]..##....[][]......[]..##[]....##........##....[]..##..####
##[]..[][][][]##........[]..[][][]....[]....[]....[][]..[]............[]..............[]....[]....##
##....[]..######[]......[]................................[]......[]....[][]....##......[]..##[][]##
##....[].....[]...[][]........[]..[]..[]......[]..[]..[][]....[][][][]..##......[]##..[][]......[]##
##[]..[].......[].[][][][]..##....[]..[]##..[]..[][]....[]##............[]..##....................##
##[]....[]....[]..[][]##[][]..............[][][]..........[]..[][]........[][][]..##..[]....[]....##
##[]....##....[]..........[]....................[][]..[][]....[]..[]....##..........##[][]....[]..##
##[]...........[]...[]....[]......[][][]....[][]........##........[]..........[]..######[]........##
####################################################################################################
