####################################################################################################
##..[]..[]..[]..##....[]..........[]....[]##[]..................[][]......[][]....[]............[]##
##....[][]##......[][]........[]##[]....[]........[]......##......[]......##......[]..[]..[]####..##
##..........##....[]......[][]..[]..[]..[]..[]##[]....[]....[]..[]......[]..[]..[]............[]..##
##............................[]..##[]..........##..##[]..##........[][]........[]......##....[][]##
##[]..[]........##..[][]..[]..[][][]....[]....[]..[][]..##....[]........[]......##....[]....[]....##
##..[]......[]....[][]....##[]............[][]..[]..[]..........[]..[]##[]..................[]....##
##..[]##....[]..[]....##..[]..[]..[]....##..[]..[]..[]##....[]....[]..[]..[][]......[]..[]........##
##............[]..........[]..[]..[][]..[]....[]....##[]..................[][]..................####
##............[]..............##..............[]............[]....##[][]......................##..##
##......[]##[]....[]........[][][][][][][][]........[]......[][]..##....[][]......[]............[]##
##..[]..##..[]..##[]........[]..[][]##....[]............................[][]....##........[][][]..##
##....[][]..####....##....[]................[]##..[]....##..##..........................[]##......##
##..[][][]##..[][]..............[][]..##[]..[]..[]....[]....##..[]..[]..[]........####..[][]......##
##....##[]..[][][][][][][][]....[]............[]......[]......[]##..##....[][]....[][]##........[]##
##..[]....[]........##....[]............##..##..[]......[]..[]##..[]..[]##..[]..........[]####....##
##............[][]..[][][][]....##[]##..##....[]........[]......[]....[]........[]....##[]....[]..##
##....[]..[]....##............[]........[][][]..[]##..[][]..##....[]................##........[]..##
##......[]................................##..[][]........##..[]....[]..##..[]..##[][]....####..[]##
##..[]..[]..[]..##..[]..[]..............[]....................[]......####[][]..[]..[]............##
##..##..[]......[][]..[]##[][]..[]......##......[][]..[][]......##............##..[]##[]..[]......##
##..................[]..[][][]............[]......##..##......[][]##..[]........[][]..[]..........##
##..........[][][][]..........[]..[]....[]..[]..[][]............[][]..[][][]##........[]....[][][]##
##......[]....................[]..[]..[]........[]..[]..............##......[]....[][]........[]..##
##..[]......##............[]........[]..##......@.....[][]..##[]..[]..##..[]..[]......##[]..[]######
##..##......[][]......[]##[][][]..........[][]....[]......##[]............[]......[]..[][]....[]..##
##[]##[]..[][][][]..[]..........[]............[]..........[]......[]..[]..............[][]....[]####
##[]..[][][]....[][]..[][]....[]....[]......####............[][]..[][]....##[]........##........[]##
##..[]......[]..[][]........[]......[]..[]..[][][]..[]......[]##....[]..[]..[]....[]....[][][][][]##
##....##..[][]..##[]##........[]..##[]..##....##......####..............[][]..##..##....[]..[][]..##
##..[][]........[]##............[]..[]....[]........[]....##[]..[]....[][]....[]##..[]......[][][]##
##......[]......##[][]..................[]##[]....##....[]....[]..##[]......[]..[]##....[][]##..[]##
##[][]........##......[]##........[]##..[]##....[]......[]..........##..........[]##[]..[][]..##..##
##....[][]......##[]..[]..[]..................[]......[]......[]......[]##..........[][]..[][]....##
##[]......[]....[]..##........[][][]......[]....[]......[][]........[]......[]..........[][]......##
##............[]........[][][][]....##................[]....##[]..[][][]##........[]..[][][]....[]##
##[]..[]......[]....##....##....[][]##......####[]....[][]####[]..[][]..[][]..[]....[]....[]....[]##
##....[]..[]..[]....[]........[]##........##....[]..[]..##[]......[][][]##[][]..[]..............[]##
##..............[][]..##..##..##..............[]..####........[]......[]..[][]..[]##..[]##........##
##..........[]......[]..##....##....[]......##[]..##....[]........................[]..[]##....##..##
##..##..[]................[]##..........[]..[]....[]....[]................##......[]..[]..[]..[][]##
####..[]....[][]....[]....[]....[]....[][]..##....[][]......[]..##[]....##........##....[]..##..####
##[]....[]....##..[]....[]..[][][]....[]....[]....[][]..[]............[]..............[]....[]....##
##......[]######..[][][][]................................[]......[]....[][]....##......[]..##[][]##
##....[]......[]....[]........[]..[]..[]......[]..[]..[][]....[][][][]..##......[]##..[][]......[]##
##[]..[]..[]............[]..##....[]..[]##..[]..[][]....[]##............[]..##....................##
##[]....[]............##[][]..............[][][]..........[]..[][]........[][][]..##..[]....[]....##
##[][]..##....[]..........[]....................[][]..[][]....[]..[]....##..........##[][]....[]..##
##............[]....[]....[]......[][][]....[][]........##........[]..........[]..######[]........##
####################################################################################################
